+---+---+---+---+---+---+---+---+---+---+---+---+---+---+---+---+
| . |   |         .   .   . |                                   |
+   +   +   +---+   +---+   +   +---+---+---+---+---+---+   +---+
| . |           | . | .   . |                           |       |
+   +---+---+---+   +   +---+---+---+---+---+---+   +---+---+   +
| .   .   . | .   . | .   .   .   . |       |       | .   .   . |
+---+---+   +   +---+---+---+---+   +   +---+   +---+   +---+   +
|       | .   . | .   .   .   .   . |           |   | .   . | . |
+---+   +---+---+   +---+---+---+---+---+   +---+   +---+   +   +
|               | .   . | .   .   .   . |       |       | . | . |
+   +---+---+   +---+   +   +---+---+   +---+   +---+   +   +   +
|       |   |       | . | . |   | .   . |           |   | . | . |
+   +   +   +---+   +   +   +   +   +---+---+---+   +   +   +   +
|   |   |           | .   . |   | . |     .   . |   |   | . | . |
+   +   +---+---+---+---+---+   +   +   +   +   +   +   +   +   +
|   |                   |       | . |   | . | . |       | . | . |
+   +---+---+---+   +   +   +   +   +---+   +   +---+---+   +   +
|   |       |       |   |   |   | . | .   . | .   .   .   . | . |
+   +---+   +   +---+---+   +   +   +   +---+---+---+---+---+   +
|           |               |     .   . |                     . |
+---+---+---+---+---+---+---+---+---+---+---+---+---+---+---+---+
